NO textures/tkt/1.png
SO textures/tkt/2.png
WE textures/tkt/3.png
EA textures/tkt/4.png
D textures/door/P01.png
D textures/door/P02.png
D textures/door/P03.png
D textures/door/P04.png
D textures/door/P05.png


F 220,100,0
C 225,30,0

        1111111111111111111111111
        1000000000110000000000001
        1000000000110000000000001
        10110000011100000S0000001
        1001000000D00000000000001
111111111011000001110000000000001
1000000000110000011111111D1111111
11110111111111011100000010001
111101111 1111011101010010001
11000000111101011100000010001
10000000000000001100000010001
1000000000000000110101001000111
1100000111010101111101111000111
11110111 1110101 101111010001
11111111 1111111 111111111111
