NO textures/forest.png
SO textures/forest.png
WE textures/forest.png
EA textures/forest.png

F 51,27,0
C 232,35,44

1111111111111
1000000000001
110000W000011
1110000000111
1111000001111
1111100011111
1111110111111
1111111111111
