NO textures/amethyst_block.png
SO textures/blackstone_top.png
WE textures/bookshelf.png
EA textures/gray_glazed_terracotta.png

F 220,100,0
C 225,30,0

        1111111111111111111111111
        1000000000110000000000001
        1000000000110000010000001
        10110000011100001N1000001
        1001000000000000010000001
111111111011000001110000000000001
100000000011000001110111110111111
11110111111111011100000010001
11110111111111011101010010001
11000000110101011100000010001
10000000000000001100000010001
1000000000000000110101001000111
1100000111010101111101111000111
11110111 1110101 101111010001
11111111 1111111 111111111111
