NO textures/amethyst_block.png
SO textures/blackstone_top.png
WE textures/bookshelf.png
EA textures/gray_glazed_terracotta.png

F 220,100,0
C 225,30,0

        1111111111111111111111111
        100000000000D000000000001
        1000000000001000000000001
        10000000000000000N0000001
        1000000000000000000000001
111111111111111111111111111111111
