NO textures/amethyst_block.png
SO textures/blackstone_top.png
WE textures/bookshelf.png
EA textures/gray_glazed_terracotta.png

F 220,100,0
C 225,30,0

11111111111111111111111111111111111111111111111111111111111111111111111111111
10000000011100000000000000000000000100000000000000000000000000000000000000001
10110000011100000000000000000000000S00000000000000000000000000000000000000001
10010000000000000000000000000000000100000000000000000000000000000000000000001
11111111111111111111111111111111111111111111111111111111111111111111111111111
