NO textures/amethyst_block.png
SO textures/blackstone_top.png
WE textures/bookshelf.png
EA textures/gray_glazed_terracotta.png
D textures/door/P01.png
D textures/door/P02.png
D textures/door/P03.png
D textures/door/P04.png
D textures/door/P05.png

F 30,250,30
C 30,30,255

11111111111111111111111
10010100000000000000001
10010100100000100000001
10010100000000000000001
10000000000100000111D11
1000E00001111D111100001
100000000D0000000D00001
10000000011100000100001
11111111111111111111111
