NO textures/amethyst_block.png
SO textures/blackstone_top.png
WE textures/bookshelf.png
EA textures/gray_glazed_terracotta.png

F a255,5,f10
C 225,30,0

111111111111111
100000000000001
100000000N00001
100000000001001
111111111111111
