NO textures/amethyst_block.png
SO textures/blackstone_top.png
WE textures/texture_test.png
EA textures/gray_glazed_terracotta.png

F 30,250,30
C 30,30,255

1111111111
1000000001
1000W00001
1000000001
1000000001
1000000001
1111111111
