NO textures/amethyst_block.png
SO textures/blackstone_top.png
WE textures/bookshelf.png
EA textures/gray_glazed_terracotta.png
D textures/bookshelf.png

F 220,100,0
C 225,30,0

        1111111111111111111111111
        1000000000010000000000001
        10000000000D0000000000001
        10000000000100000N0000001
        1000000000000000000000001
111111111111111111111111111111111
