NO textures/txt.png
SO textures/txt.png
WE textures/txt.png
EA textures/txt.png

F 220,100,0
C 225,30,0

111111111111111
100000000000001
100000000000001
100000000001001
111111111111111
