NO textures/amethyst_block.png
SO textures/blackstone_top.png
WE textures/bookshelf.png
EA textures/gray_glazed_terracotta.png

F 30,250,30
C 30,30,255

11111111111111111111111
10010100000000000000001
10010100100000100000001
10010100000000000000001
10000000000100000111011
1000E000011110111100001
10000000000000000000001
10000000011100000100001
11111111111111111111111
