NO textures/space.png
SO textures/space.png
WE textures/space.png
EA textures/space.png

F 0,0,0
C 0,0,0

        1111111111111111111111111
        1000000000110000000000001
        1000000000110000010000001
        10110000011100100N1000001
        1001000000000001000000001
111111111011000001110000000000001
100000000011000001110111110111111
11110111111111011100000010001
111101111 1111011101010010001
11000100111101011100000010001
10000100000000001100000010001
1000101000000000110101001000111
1100010111010101111101111000111
11110111 1110101 101111010001
11111111 1111111 111111111111
