NO textures/wall_castle.png
SO textures/wall_castle.png
WE textures/wall_castle.png
EA textures/wall_castle.png

F 238,130,238
C 238,130,238

11111111111111111
10000000000000001
10000011111000001
1000001   1000001
100E001   1000001
1000001   1000001
10000011111000001
10000000000000001
11111111111111111
