NO textures/color/red.png
SO textures/color/green.png
WE textures/color/bleu.png
EA textures/color/white.png

F 238,130,238
C 238,130,238

11111111111111111
10000000000000001
10000011D11000001
10000010N01000001
100000D000D000001
10000010001000001
10000011D11000001
10000000000000001
11111111111111111
